--------------------
| |                |
| | |              |
| | |              |
| | |              |
|   |              |
|----              |
|                  |
|                  |
|                  |
|                  |
|                  |
|                  |
|                  |
|                  |
|                  |
|                  |
|                  |
|                  |
--------------------